111111
1E0001
101001
1010C1
1P0001
111111