1111111111111111111111111111111111
1E00000000000C000000A000E000000001
1010010100100000101001000000010101
1010010010101010001001000C00010101
1P0000000C00000000000000C0000000C1
1111111111111111111111111111111111